# FlexKey Keywords

# Data Types (KEYWORD1)
FlexKeyStorage	KEYWORD1
FlexKeyButton	KEYWORD1
FlexKeyWiFi	KEYWORD1
FlexKeyRFID	KEYWORD1
FlexKeyRelay	KEYWORD1
FlexKeyHTTP	KEYWORD1
FlexKeyWeb	KEYWORD1
SystemConfig_t	KEYWORD1
WiFiConfig_t	KEYWORD1
Group_t	KEYWORD1
UID_t	KEYWORD1
LastUID_t	KEYWORD1
GlobalRelayConfig_t	KEYWORD1

# Methods and Functions (KEYWORD2)
begin	KEYWORD2
update	KEYWORD2
factoryReset	KEYWORD2
saveSystemConfig	KEYWORD2
loadSystemConfig	KEYWORD2
saveGroup	KEYWORD2
loadGroup	KEYWORD2
saveWiFiConfig	KEYWORD2
loadWiFiConfig	KEYWORD2
isPressed	KEYWORD2
getHoldDuration	KEYWORD2
startAP	KEYWORD2
stopAP	KEYWORD2
connectToWiFi	KEYWORD2
isConnected	KEYWORD2
getIPAddress	KEYWORD2
getMACAddress	KEYWORD2
readCard	KEYWORD2
isReady	KEYWORD2
toggle	KEYWORD2
pulse	KEYWORD2
setState	KEYWORD2
getState	KEYWORD2
turnOn	KEYWORD2
turnOff	KEYWORD2
sendGET	KEYWORD2
sendMultipleGET	KEYWORD2
handleClient	KEYWORD2
isRunning	KEYWORD2

# Constants (LITERAL1)
MAX_GROUPS	LITERAL1
MAX_UIDS	LITERAL1
MAX_URLS_PER_GROUP	LITERAL1
MAX_URL_LENGTH	LITERAL1
FLEXKEY_VERSION	LITERAL1
SYSTEM_NAME	LITERAL1
PIN_I2C_SDA	LITERAL1
PIN_I2C_SCL	LITERAL1
PIN_BUTTON	LITERAL1
PIN_RELAY	LITERAL1
PIN_STATUS_LED	LITERAL1
